11 10
2 2 2 1 6 7 6 2 1 2
 2 4 4 1 6 7 6 2 1 0
4 4 2 1 8 8 8 1 1 1
 4 2 1 6 7 6 5 2 2 0
2 2 1 6 7 6 5 2 2 2
 2 1 6 7 6 5 2 2 2 0
2 1 2 6 7 6 5 2 2 2
 2 1 2 2 9 7 6 6 6 0
2 3 1 1 2 9 7 7 7 7
 3 3 3 1 2 2 6 6 6 0
2 2 3 2 1 2 2 2 2 2