59 50
2 2 2 2 2 3 2 2 2 2 1 1 2 2 2 2 2 2 2 2 2 2 2 2 2 1 2 2 2 3 2 2 2 2 2 5 5 5 6 6 6 6 7 7 7 7 7 7 7 7 
2 2 3 2 2 2 2 2 2 2 1 1 2 2 3 2 2 3 2 2 2 2 2 2 2 1 2 2 2 2 2 3 2 2 2 5 5 5 6 6 6 6 7 7 7 7 7 7 7 7 
2 2 2 2 2 2 2 2 2 2 2 1 1 2 3 2 2 2 2 2 2 2 3 2 2 2 1 1 2 2 2 2 2 2 2 2 5 5 5 5 6 6 6 9 9 7 7 7 7 7 
2 3 2 2 2 2 2 3 2 3 2 1 1 2 3 2 2 3 2 2 2 3 2 2 2 2 2 1 2 2 2 2 2 3 2 2 5 5 5 5 6 6 6 9 9 7 7 9 7 7 
2 2 2 2 3 2 2 2 2 2 2 2 1 1 2 2 2 3 2 2 2 3 2 2 2 2 2 2 1 1 2 2 2 2 2 2 3 2 5 5 5 6 6 6 9 7 7 7 7 7 
2 2 2 2 2 2 2 2 2 2 2 2 1 1 2 3 2 2 2 2 2 2 2 2 3 2 2 2 2 1 1 2 2 2 3 2 2 2 5 5 5 6 6 7 7 7 7 7 9 7 
2 2 2 2 2 2 3 2 2 2 2 2 2 1 1 2 2 2 2 2 2 2 2 2 2 2 2 2 2 2 2 1 1 2 2 3 2 2 2 5 5 6 6 6 7 7 7 7 7 7 
2 2 2 2 2 2 2 2 2 2 3 2 2 1 1 2 2 2 2 3 2 2 2 2 2 2 2 2 2 3 2 2 1 1 2 2 3 2 2 5 5 6 6 7 7 7 7 7 7 7 
2 2 2 3 2 2 2 2 3 2 2 2 2 2 1 1 2 2 2 3 2 2 3 2 2 2 2 3 2 2 2 2 2 2 1 2 2 2 2 3 5 6 6 7 7 7 7 7 7 7 
2 2 2 2 3 3 2 2 3 2 2 2 2 3 1 1 2 2 2 2 2 2 2 2 2 2 2 2 2 2 2 2 2 2 1 1 2 2 2 2 6 6 7 7 7 7 7 7 9 7 
2 2 2 2 2 2 2 2 2 2 2 2 3 2 2 1 1 2 2 2 2 2 2 2 3 3 2 2 2 2 2 3 2 2 2 2 1 2 2 2 6 6 6 7 7 7 7 7 9 9 
2 3 2 2 2 3 2 2 3 2 2 2 2 3 2 1 1 2 2 3 3 2 2 3 2 2 2 2 2 2 2 2 2 2 2 2 1 2 2 6 6 6 7 7 7 7 7 9 6 6 
2 2 2 3 2 2 2 2 2 2 2 3 2 2 2 2 1 1 2 2 2 3 2 2 2 2 3 2 2 2 2 2 2 2 2 2 1 1 2 2 6 6 7 7 7 7 7 6 6 6 
2 2 2 2 2 2 2 2 2 2 2 3 2 3 2 2 1 1 2 2 2 2 2 3 2 2 2 2 3 3 2 2 2 2 2 1 1 1 2 6 6 7 7 7 7 7 6 6 6 6 
3 2 2 3 2 2 3 2 2 2 2 2 2 2 3 2 2 1 1 2 2 2 2 2 2 2 2 2 2 2 2 2 2 3 2 1 1 1 1 6 6 7 7 7 7 6 6 6 6 6 
2 2 2 2 2 2 2 5 5 5 5 2 2 2 2 2 2 1 1 2 3 2 2 2 3 3 2 2 2 2 2 2 2 2 1 1 2 1 8 6 7 7 7 7 6 6 6 5 5 6 
2 2 2 2 2 2 5 5 6 6 6 5 5 2 3 2 2 2 1 1 2 2 2 2 2 2 2 2 2 2 2 2 2 2 1 1 2 2 8 8 7 7 7 7 6 6 6 5 5 5 
2 2 2 5 5 5 6 6 6 6 6 6 5 5 2 2 2 2 1 1 2 2 2 3 2 3 3 3 2 2 2 2 2 1 1 2 2 6 8 8 7 7 6 6 6 6 5 5 5 5 
2 5 5 5 6 6 6 6 6 6 6 6 6 6 5 5 2 2 2 1 1 2 2 2 3 3 2 2 3 2 2 2 2 1 1 2 2 6 6 8 8 7 6 6 6 6 2 2 2 5 
6 6 6 6 6 6 7 7 7 7 7 6 6 6 6 5 2 2 1 1 2 2 2 3 3 3 3 3 2 3 2 2 1 1 2 2 6 6 6 8 8 6 6 6 6 2 2 2 2 2 
6 6 6 6 6 7 7 7 7 7 7 7 7 6 6 6 5 2 2 1 1 2 2 3 2 2 3 2 3 3 2 2 1 1 2 2 2 6 6 7 8 8 6 6 2 2 2 2 2 2 
9 9 7 7 7 7 7 7 7 9 9 9 7 7 6 6 2 2 1 1 2 2 2 3 2 3 2 2 2 3 2 1 1 2 2 2 6 6 9 7 8 8 6 6 2 2 2 2 2 2 
9 9 7 7 7 7 6 6 6 6 9 9 7 7 7 6 6 2 2 1 1 2 2 3 3 2 3 3 3 2 2 1 1 2 2 2 6 6 9 7 7 8 8 6 2 2 2 2 2 2 
7 7 7 7 6 6 6 6 6 6 6 9 7 7 7 6 6 2 2 1 1 2 2 2 3 3 2 3 3 2 1 1 2 2 2 2 6 9 7 7 6 8 8 2 2 2 2 2 2 2 
7 7 6 6 6 6 6 2 2 2 6 6 6 7 7 7 6 6 2 2 1 1 2 2 2 2 3 2 2 2 1 1 2 2 2 2 6 6 9 7 6 6 8 1 2 2 2 2 2 2 
6 6 6 6 6 2 2 2 2 2 2 6 6 7 7 7 6 6 2 2 1 1 2 2 2 2 3 2 2 1 1 2 2 2 2 6 6 9 7 6 6 6 1 1 2 2 2 2 2 2 
6 6 6 6 2 2 2 2 2 2 2 2 6 6 7 7 7 6 6 2 2 1 1 2 2 3 2 2 2 1 1 2 2 2 2 2 6 6 7 7 6 6 2 1 1 2 2 2 2 2 
2 2 2 2 2 2 2 2 2 2 2 2 6 6 7 7 7 6 6 2 2 1 1 2 2 2 2 2 1 1 2 2 2 2 2 6 6 7 7 6 6 2 2 1 1 2 2 2 2 2 
2 2 2 2 2 2 2 2 2 2 2 2 2 6 6 7 7 6 6 2 2 2 1 1 1 1 1 1 1 1 2 2 2 2 2 6 6 7 7 6 6 2 2 2 1 1 2 2 2 2 
2 2 2 2 2 2 2 2 2 2 2 2 2 6 6 7 7 6 6 2 2 1 1 1 1 1 1 1 1 2 2 2 2 2 6 6 7 7 6 6 2 2 2 2 1 2 2 2 2 2 
2 2 2 2 2 2 2 2 2 2 2 2 2 2 6 7 7 7 6 6 2 1 1 2 2 2 2 2 2 2 2 2 2 2 6 6 7 7 6 6 6 2 2 2 2 2 2 2 2 2 
2 2 2 2 2 2 2 2 2 2 2 2 2 6 6 7 7 7 6 6 1 1 2 2 2 2 2 2 2 2 2 2 2 6 6 9 7 7 6 6 5 2 2 2 2 2 2 2 2 2 
2 2 2 2 2 2 2 2 2 2 2 2 2 2 6 6 7 7 6 6 8 1 2 2 2 2 2 2 2 2 2 2 6 6 6 9 7 7 6 6 5 2 2 2 2 2 2 2 2 2 
2 2 2 2 2 2 2 2 2 2 2 2 2 2 6 6 7 7 6 8 8 2 2 2 2 2 2 2 2 2 2 6 6 6 9 7 7 6 6 5 2 2 2 2 2 2 2 2 2 2 
2 2 2 2 2 2 2 2 2 2 2 2 2 2 2 6 6 7 7 8 8 6 6 6 2 2 2 2 2 6 6 6 6 6 7 7 7 6 6 5 2 2 2 2 2 2 2 2 2 2 
2 2 2 2 2 2 2 2 2 2 2 2 2 2 2 6 6 7 8 8 6 6 6 6 6 6 6 6 6 6 6 6 6 7 7 7 6 6 5 2 2 2 2 2 2 2 2 2 2 2 
2 2 2 2 2 2 2 2 2 2 2 2 2 2 2 2 6 6 8 8 7 7 7 6 6 6 6 6 6 6 6 6 7 7 7 7 6 6 5 2 2 2 2 2 2 2 2 2 2 2 
2 2 2 2 2 2 2 2 2 2 2 2 2 2 2 2 6 8 8 7 7 7 7 7 9 9 9 7 7 6 7 7 7 7 6 6 6 5 2 2 2 2 2 2 2 2 2 2 2 2 
2 2 2 2 2 2 2 2 2 2 2 2 2 2 2 2 2 8 8 6 7 7 7 7 7 9 7 7 7 7 7 7 7 7 6 6 6 5 2 2 2 2 2 2 2 2 2 2 2 2 
2 2 2 2 2 2 2 2 2 2 2 2 2 2 2 2 1 8 6 6 7 7 7 7 7 7 7 7 7 7 7 7 6 6 6 5 5 2 2 2 2 2 2 2 2 2 2 2 2 2 
2 2 2 2 2 2 2 2 2 2 2 2 2 2 2 2 1 1 2 6 6 6 7 7 7 7 7 6 6 6 6 6 6 6 6 5 2 2 2 2 2 2 2 2 2 2 2 2 2 2 
2 2 2 2 2 2 2 2 2 2 2 2 2 2 2 1 1 2 2 2 6 6 7 7 7 7 6 6 6 6 6 6 6 5 5 2 2 2 2 2 2 2 2 2 2 2 2 2 2 2 
2 2 2 2 2 2 2 2 2 2 2 2 2 2 2 1 1 2 2 2 2 6 6 7 7 6 6 6 5 5 5 5 5 5 2 2 2 2 2 2 2 2 2 2 2 2 2 2 2 2 
2 2 2 2 2 2 2 2 2 2 2 2 2 2 1 1 2 2 2 2 2 6 6 7 6 6 6 5 2 2 2 2 2 2 2 2 2 2 2 2 2 2 2 2 2 2 2 2 2 2 
2 2 2 2 2 2 2 2 2 2 2 2 2 2 1 1 2 2 2 2 2 2 6 6 6 6 6 2 2 2 2 2 2 2 2 2 2 2 2 2 2 2 2 2 2 2 2 2 2 2 
2 2 2 2 2 2 2 2 2 2 2 2 2 2 1 2 2 2 2 2 2 2 6 6 6 2 2 2 2 2 2 2 2 2 2 2 2 2 2 2 2 2 2 2 2 2 2 2 2 2 
2 2 2 2 2 2 2 2 2 2 2 2 2 2 2 1 2 2 2 2 2 2 6 6 6 2 2 2 2 2 2 2 2 2 2 2 2 2 2 2 2 2 2 2 2 2 2 2 2 2 
2 2 2 2 2 2 2 2 2 2 2 2 2 2 2 1 2 2 2 2 2 2 6 6 2 2 2 2 2 2 2 2 2 2 2 2 2 2 2 2 2 2 2 2 2 2 2 2 2 2 
2 2 2 2 2 2 2 2 2 2 2 2 2 2 2 2 1 2 2 2 2 2 6 6 6 2 2 2 2 2 2 2 2 2 2 2 2 2 2 2 2 2 2 2 2 2 2 2 2 2 
2 2 2 2 2 2 2 2 2 2 2 2 2 2 2 2 1 2 2 2 2 6 6 6 2 2 2 2 2 2 2 2 2 2 2 2 2 2 2 2 2 2 2 2 2 2 2 2 2 2 
2 2 2 2 2 2 2 2 2 2 2 2 2 2 2 2 2 1 2 2 2 6 6 6 2 2 2 2 2 2 2 2 2 2 2 2 2 2 2 2 2 2 2 2 2 2 2 2 2 2 
2 2 2 2 2 2 2 2 2 2 2 2 2 2 2 2 2 1 2 2 2 6 6 6 2 2 2 2 2 2 2 2 2 2 2 2 2 2 2 2 2 2 2 2 2 2 2 2 2 2 
2 2 2 2 2 2 2 2 2 2 2 2 2 2 2 2 2 2 1 1 1 8 8 8 1 1 1 1 1 2 2 2 2 2 2 2 2 2 2 2 2 2 2 2 2 2 2 2 2 2 
2 2 2 2 2 2 2 2 2 2 2 2 2 2 2 2 2 2 2 2 2 6 6 2 2 2 2 2 2 2 2 2 2 2 2 2 2 2 2 2 2 2 2 2 2 2 2 2 2 2 
2 2 2 2 2 2 2 2 2 2 2 2 2 2 2 2 2 2 2 2 2 6 6 6 2 2 2 2 2 2 2 2 2 2 2 2 2 2 2 2 2 2 2 2 2 2 2 2 2 2 
2 2 2 2 2 2 2 2 2 2 2 2 2 2 2 2 2 2 2 2 6 6 6 2 2 2 2 2 2 2 2 2 2 2 2 2 2 2 2 2 2 2 2 2 2 2 2 2 2 2 
2 2 2 2 2 2 2 2 2 2 2 2 2 2 2 2 2 2 2 2 2 6 6 6 2 2 2 2 2 2 2 2 2 2 2 2 2 2 2 2 2 2 2 2 2 2 2 2 2 2 
2 2 2 2 2 2 2 2 2 2 2 2 2 2 2 2 2 2 2 2 6 6 6 2 2 2 2 2 2 2 2 2 2 2 2 2 2 2 2 2 2 2 2 2 2 2 2 2 2 2 
2 2 2 2 2 2 2 2 2 2 2 2 2 2 2 2 2 2 2 2 2 6 6 2 2 2 2 2 2 2 2 2 2 2 2 2 2 2 2 2 2 2 2 2 2 2 2 2 2 2 
