20 20
2	2	2	2	2	1	2	2	3	2	2	2	2	3	2	2	1	2	6	7	
2	2	4	2	2	1	2	2	3	2	3	3	2	3	2	1	2	6	7	7	
2	4	4	4	4	2	1	3	2	3	2	3	3	2	3	1	3	6	9	7	
2	2	2	2	2	2	1	2	3	3	2	3	2	3	1	2	6	9	7	6	
2	2	4	4	2	4	2	1	2	2	3	3	3	3	1	1	6	9	7	6	
2	2	2	4	2	2	4	1	1	1	1	1	1	1	5	8	9	7	6	2	
1	4	4	4	2	4	2	2	1	3	3	2	2	5	5	6	8	7	6	2	
1	2	2	4	4	4	2	1	3	2	5	5	5	6	6	7	8	6	2	2	
2	1	4	2	2	4	2	1	2	2	5	6	6	6	7	7	6	1	2	2	
2	1	4	4	4	2	1	2	5	5	6	6	7	7	6	6	5	1	2	1	
2	4	1	1	1	1	1	5	5	6	6	7	7	9	9	6	5	2	1	1	
2	2	4	1	3	3	5	6	6	7	7	7	6	6	5	5	2	2	1	2	
4	4	2	1	3	2	6	6	9	9	7	7	6	6	5	2	2	2	1	2	
4	2	1	2	2	6	9	9	7	7	6	6	5	5	2	3	2	1	4	4	
1	1	1	2	6	6	7	7	7	6	6	5	5	2	2	2	2	1	2	2	
3	2	8	6	7	7	7	6	6	5	5	2	2	3	3	2	1	2	4	2	
3	2	6	8	7	7	6	6	3	3	2	2	3	3	2	3	1	2	4	4	
2	6	6	8	6	6	2	2	2	3	3	3	2	3	2	1	2	4	2	2	
2	6	6	7	8	6	2	2	2	2	2	2	2	2	2	1	2	2	4	4	
6	6	7	6	1	1	1	1	1	1	1	1	1	1	1	2	4	4	2	4